L,5,5,N
H,7,6,5,7,5,7,4,7,3,6,3,5,3,5,4
W,5,3,4,4
W,4,4,3,5
W,3,5,3,6
W,3,6,3,7
W,3,7,3,8
W,3,8,4,9
W,4,9,5,9
W,5,9,6,9
D,6,9,6,8
W,6,8,6,7
D,6,7,6,6
W,6,6,5,6
W,5,6,6,5
W,6,5,7,6
W,7,6,8,6
W,8,6,8,5
W,8,5,8,4
W,8,4,7,3
W,7,3,6,3
W,6,3,5,3
S,7,5,G,G,R
S,6,4,R,R,R
S,4,6,G,R,G
S,4,8,G,G,G
S,5,7,G,R,R
